IIIIIIIIIIIIIIIIIIIIIAAAAAAAAAAAAAAAAAAAAA
IIIIIIIIIIIIIIIIIIIIIIIIIIAAAAAAAAAAAAAAAA
MMMMMMMMMMMFMMMMMMMMMMMMMMMAAAAAAAAAAAAAAA
GTTTTTTTTGTTTTTTTTTTTTTTTTGGAAAAAAAAAAAAAA
GGTTTTTTTGTTTTTTTTTTTTTTGTGTAAAAAAAAAAAAAA
GGGTTTTPGGGPTTTTTTTTTTTTGGGTAAAAAAAAAAAAAA
GGTTTTTPGTGPTTTTTTTTTTGGGTTTAAAAAAAAAAAAAA
GGTTTTPGTTTGPTTTTTTTTGGGTTTAAAAAAAAAAAAAAA
GGGTTPGTTWTTGPTGGTTTTGGTTAAAAAAAAAAAAAAAAA
GGGGTTPGTTTGPTTTGGTTTAAAAAAAAAAAAAAAAAAAAA
GGGTTTTPGGGPTTTTTGGGTAAAAAAAAAAAAAAAAAAAAA
GGTTTTTTPPPTTTTTTTAAAAAAAAAAAAAAAAAAAAAAAA
GGGTTTTTTTTTTTTTTTAAAAAAAAAAAAAAAAAAAAAAAA
TTGGTTTTTTTTTTTTTAAAATTTTTAAAAAAAAAAAAAAAA
TTTGGTTTTTTGTTAAAAATTTGGGGGAAAAAAAAAAAAAAA
TTTTGGTTTTGGTTAAAATTTGGTTTGGAAAAAAAAAAAAAA
TTGTTGGGGGGTTTTTTTTTGGTTAAAAAAAAAAAAAAAAAA
TTGGGGGGGGTTTTTTTGGGGTTAATTTAAAAAAAAAAAAAA
PTTTGGGGGTTTTTTGGGTTTTTAAGTTAAAAABTTAATTTT
GPTTTGGGGTTTTTTTGGTAAAAATGGTAAAAAPPPAATTTT
TGPTTTTTGGTTTTTGTTTATTTTTTGGAAAAATTAAATTTT
CTGPTTTTTGGTTTTTTTTATTTTTTTGAAAAATTTTAATTT
TTTGPTTTTTGGTTTTTTTTTGGTTTGGAAAAAAATTTTTTT
TTTTGPTTTTTTTTTTTTGGGGGGGGGTAAAAAAATTTTTTT
TTTGPTTTTPPPPTTTTTGGTTTTGGTTAAAATTTTTTTTTT
TTGPTTTTTTTTTPTTTGTTTTTAAAAAAAAATTTTTTTTTT
TGPTTTTTPTTTTTPTTAAAAAAAAAAAAAAATTTTTTTTTT
TGPTTGTTTPTTTTPTAAAAAAAAAAAAAAAAATTTTTTTTT
TGPTTGGTTTPTTKPTAAAAAAATTTAAAAAAAAAATTTTTT
TPPTTGGGTTTPTTPTTAAAAAATTTTAAAAAAAAATTTTTT
TPTTGGTGGTTTPTPTTTTTTTTTTTTAAAAAAAATTTTTTT
TTTTGTTTGGTTPTTPTTTTTGGTTTTTAAAAATTTTTTTTT
TTTTTTTTTGGTPPTTPTTGGGGGGTTTAAAAATTTTTTTTT
TTPPPPPTTTGGTTPTTPGGGGGGGGTTAAAAAAATTTTTTT
GTTTTGGPTTTGGTTPTGGGGGGGGGGTAAAAATTTTTTTTT
GGTTGGGGPTTTGGTTPTGGGGGGGGTHAAAAATTTTTTTTT
TGGTTGGGGPTTTGGTTGGGGGGGGGTTAAAAAAATTTTTDT
TTGTGGTTGTPTTTGGGGGTGGGGGTTTAAAAAAATTTTTTT
TTTGGTTTTPTTTTTGGGTTTGGGTTTTAAAAAAATTTTTTT
TTGGGTTTPTTTTTGGGTTTTTGTTTTAAAAAAATTTTTTTT
TTTGTTTPTTTTTTTTTTTTTTTTTAAAAAAAAATTTTTTTT
TTTGGTTTTTTTTTTTTTTTTTTTAAAAAAAAATTTTTTTTT
